"aD" = (/obj/structure/fence/door,/obj/structure/barricade/wooden/crude,/turf/template_noop,/area/template_noop)
"aK" = (/obj/machinery/door/poddoor/shutters{id = "abandoned_factory_shutters_west"},/turf/open/floor/plating/rust,/area/ruin/unpowered)
"aX" = (/obj/machinery/conveyor{dir = 4; id = "abandoned_factory_conveyor"},/obj/item/chair,/obj/machinery/light/small/built/directional/north,/obj/structure/sign/poster/official/obey{pixel_y = 32},/turf/open/floor/iron/smooth_large,/area/ruin/unpowered)
"aY" = (/obj/structure/girder,/obj/structure/pitgrate,/turf/open/floor/plating/planetary/rock,/area/ruin/unpowered)
"bc" = (/obj/effect/spawner/clear,/turf/template_noop,/area/ruin/unpowered)
"bn" = (/obj/structure/fence/door,/obj/structure/barricade/wooden/crude,/turf/open/floor/plating/planetary/rock,/area/template_noop)
"bp" = (/obj/effect/turf_decal/stripes/line,/obj/effect/decal/cleanable/dirt/dust,/obj/structure/table,/obj/item/stack/sheet/iron/ten,/turf/open/floor/iron/smooth_large,/area/ruin/unpowered)
"bw" = (/obj/structure/fence/corner{dir = 5},/obj/effect/spawner/clear,/obj/effect/spawner/clear,/turf/template_noop,/area/template_noop)
"bE" = (/obj/structure/fence,/obj/effect/spawner/clear,/turf/template_noop,/area/template_noop)
"bZ" = (/obj/structure/fence,/turf/open/floor/plating/planetary/rock,/area/template_noop)
"cf" = (/turf/closed/wall/r_wall,/area/ruin/unpowered)
"cD" = (/obj/structure/grille,/obj/structure/window/reinforced/fulltile,/obj/structure/barricade/wooden/crude,/obj/machinery/door/poddoor/shutters{id = "abandoned_factory_window_shutters"},/turf/open/floor/plating/rust,/area/ruin/unpowered)
"cP" = (/obj/structure/safe,/obj/effect/spawner/lootdrop/ammo,/obj/effect/spawner/lootdrop/ammo,/obj/effect/spawner/lootdrop/ballistic_weapon,/obj/effect/spawner/lootdrop/cash/five,/turf/open/floor/iron/grimy,/area/ruin/unpowered)
"dl" = (/obj/effect/decal/remains/human,/obj/effect/decal/cleanable/blood/footprints{dir = 8; pixel_x = -13; pixel_y = 13},/obj/effect/decal/cleanable/blood/footprints,/obj/item/gun/ballistic/automatic/pistol/m1911/no_mag,/turf/open/floor/iron/grimy,/area/ruin/unpowered)
"do" = (/obj/effect/turf_decal/loading_area{dir = 1},/obj/effect/decal/cleanable/oil,/turf/open/floor/iron/smooth_large,/area/ruin/unpowered)
"dx" = (/obj/structure/chair/comfy/brown,/obj/effect/decal/cleanable/blood/old,/obj/effect/decal/cleanable/blood/footprints{dir = 8; pixel_x = -13; pixel_y = 13},/obj/structure/spider/stickyweb,/turf/open/floor/iron/grimy,/area/ruin/unpowered)
"dG" = (/obj/structure/filingcabinet,/obj/effect/decal/cleanable/cobweb/cobweb2,/obj/machinery/button/door/directional/south{id = "abandoned_factory_north_shutters"; name = "North Bay Shutters"},/obj/machinery/button/door/directional/south{id = "abandoned_factory_shutters_west"; name = "West Bay Shutters"; pixel_y = -30},/obj/structure/spider/stickyweb,/obj/machinery/button/door/directional/south{id = "abandoned_factory_window_shutters"; name = "Window Shutters"; pixel_y = -37},/turf/open/floor/iron/grimy,/area/ruin/unpowered)
"eb" = (/obj/structure/grille/broken,/obj/structure/window/reinforced/fulltile,/obj/structure/barricade/wooden/crude,/obj/machinery/door/poddoor/shutters{id = "abandoned_factory_window_shutters"},/turf/open/floor/plating/rust,/area/ruin/unpowered)
"ee" = (/obj/structure/toilet{dir = 4},/obj/effect/decal/cleanable/blood/old,/obj/effect/decal/cleanable/cobweb,/turf/open/floor/iron/checker/airless,/area/ruin/unpowered)
"ex" = (/obj/structure/pitgrate,/obj/effect/spawner/clear,/turf/template_noop,/area/ruin/unpowered)
"eU" = (/obj/structure/table,/turf/open/floor/plating/rust,/area/ruin/unpowered)
"fk" = (/obj/structure/fence/door{dir = 8; open = 1},/obj/effect/spawner/clear,/turf/open/floor/plating/planetary/rock,/area/template_noop)
"fo" = (/obj/effect/decal/cleanable/blood/old{pixel_x = -12},/obj/effect/decal/remains/human{pixel_x = -23; pixel_y = 7},/obj/effect/decal/cleanable/dirt,/obj/item/kitchen/knife/shiv{pixel_y = -3},/obj/machinery/light/small/directional/east,/obj/structure/sink{pixel_y = 20},/turf/open/floor/plating/rust,/area/ruin/unpowered)
"fy" = (/obj/structure/bed/maint{pixel_y = 5},/obj/effect/decal/cleanable/dirt,/obj/effect/spawner/lootdrop/food_packaging,/turf/open/floor/plating/rust,/area/ruin/unpowered)
"fM" = (/obj/machinery/autolathe,/turf/open/floor/iron/smooth_large,/area/ruin/unpowered)
"gb" = (/obj/structure/bed/maint{pixel_y = 6},/obj/effect/decal/cleanable/dirt,/obj/effect/spawner/lootdrop/prison_contraband,/turf/open/floor/iron/smooth_large,/area/ruin/unpowered)
"gg" = (/obj/structure/bed/maint{pixel_y = 3},/obj/effect/decal/remains/human,/obj/effect/decal/cleanable/dirt,/turf/open/floor/iron/smooth_large,/area/ruin/unpowered)
"gs" = (/obj/structure/fence{dir = 8},/obj/effect/spawner/clear,/turf/template_noop,/area/template_noop)
"gJ" = (/obj/structure/fence/door{dir = 8},/obj/effect/spawner/clear,/obj/effect/spawner/clear,/turf/template_noop,/area/template_noop)
"gV" = (/obj/structure/bed/maint{pixel_y = 5},/obj/effect/decal/cleanable/generic,/obj/effect/decal/remains/human,/obj/effect/decal/cleanable/blood/old,/turf/open/floor/plating/rust,/area/ruin/unpowered)
"hR" = (/obj/machinery/shower{dir = 4},/obj/effect/decal/cleanable/dirt,/turf/open/floor/plating/rust,/area/ruin/unpowered)
"if" = (/obj/item/trash/can{pixel_x = 15; pixel_y = 15},/obj/item/trash/can{pixel_x = 12; pixel_y = 3},/obj/structure/chair/stool{dir = 4},/obj/effect/decal/cleanable/vomit/old,/obj/effect/decal/cleanable/dirt,/obj/effect/spawner/lootdrop/food_packaging,/turf/open/floor/iron/smooth_large,/area/ruin/unpowered)
"iE" = (/obj/structure/table/greyscale,/obj/item/trash/waffles,/obj/effect/decal/cleanable/cobweb/cobweb2,/obj/effect/spawner/lootdrop/food_packaging,/obj/effect/spawner/lootdrop/food_packaging,/turf/open/floor/iron/smooth_large,/area/ruin/unpowered)
"iK" = (/obj/structure/fence/corner{dir = 6},/obj/effect/spawner/clear,/turf/template_noop,/area/template_noop)
"js" = (/obj/structure/chair/greyscale{dir = 8},/obj/machinery/light/small/broken/directional/north,/obj/effect/decal/cleanable/oil/slippery,/turf/open/floor/plating/planetary/rock,/area/ruin/unpowered)
"ju" = (/obj/effect/decal/cleanable/oil,/turf/open/floor/plating/rust,/area/ruin/unpowered)
"kI" = (/turf/open/floor/iron/smooth_large,/area/ruin/unpowered)
"la" = (/obj/effect/turf_decal/caution/stand_clear/red,/obj/effect/decal/cleanable/dirt,/turf/open/floor/iron/smooth_large,/area/ruin/unpowered)
"lg" = (/obj/structure/closet/crate,/obj/effect/turf_decal/box/corners{dir = 4},/obj/effect/turf_decal/box/corners{dir = 1},/obj/effect/decal/cleanable/cobweb/cobweb2,/obj/effect/spawner/lootdrop/away_loot,/obj/machinery/light/small/red/directional/north,/turf/open/floor/iron/smooth_corner{dir = 8},/area/ruin/unpowered)
"mC" = (/obj/structure/closet/cabinet,/obj/effect/spawner/lootdrop/clothes,/obj/effect/spawner/lootdrop/away_loot,/obj/effect/spawner/lootdrop/shoes,/turf/open/floor/iron/grimy,/area/ruin/unpowered)
"nI" = (/turf/template_noop,/area/template_noop)
"nP" = (/obj/machinery/conveyor{dir = 4; id = "abandoned_factory_conveyor"},/turf/open/floor/iron/smooth_large,/area/ruin/unpowered)
"oF" = (/obj/effect/decal/cleanable/dirt,/turf/open/floor/iron/smooth_large,/area/ruin/unpowered)
"oV" = (/obj/effect/decal/cleanable/blood/footprints{dir = 1; pixel_x = -4; pixel_y = 13},/obj/effect/decal/cleanable/blood/footprints{dir = 1; pixel_x = -11; pixel_y = 3},/obj/effect/decal/cleanable/blood/footprints,/obj/effect/decal/cleanable/dirt,/obj/item/ammo_casing/c45{dir = 1; pixel_x = 7; projectile_type = null},/mob/living/simple_animal/hostile/giant_spider/tarantula,/turf/open/floor/iron/grimy,/area/ruin/unpowered)
"ph" = (/obj/structure/table/wood,/obj/item/paper/crumpled/bloody{pixel_x = -6; pixel_y = 7},/obj/item/pen/fountain{pixel_x = -5; pixel_y = 10},/obj/item/newspaper{pixel_x = 7; pixel_y = -4},/obj/item/ammo_box/magazine/m45{pixel_x = 13; pixel_y = 6; start_empty = 1},/obj/item/ammo_box/magazine/m45,/turf/open/floor/iron/grimy,/area/ruin/unpowered)
"pi" = (/obj/structure/table/wood,/obj/machinery/light/small/broken/directional/east,/obj/structure/spider/stickyweb,/turf/open/floor/iron/grimy,/area/ruin/unpowered)
"pm" = (/obj/structure/fence/cut/medium{dir = 8},/turf/open/floor/plating/rust,/area/ruin/unpowered)
"pr" = (/obj/effect/decal/cleanable/dirt,/turf/open/floor/plating/rust,/area/ruin/unpowered)
"qm" = (/obj/machinery/door/airlock/maintenance_hatch,/turf/open/floor/plating/rust,/area/ruin/unpowered)
"qn" = (/obj/effect/decal/remains/human,/obj/effect/decal/cleanable/blood/old,/turf/open/floor/plating/rust,/area/ruin/unpowered)
"qB" = (/obj/structure/frame/computer{anchored = 1},/turf/open/floor/iron/smooth_large,/area/ruin/unpowered)
"qF" = (/obj/effect/decal/cleanable/generic{pixel_x = -2},/obj/item/ammo_casing/c45{dir = 4; pixel_x = 9; pixel_y = 7; projectile_type = null},/obj/effect/decal/cleanable/blood/old,/turf/open/floor/plating/rust,/area/ruin/unpowered)
"rd" = (/obj/effect/decal/cleanable/generic,/obj/structure/cable,/turf/open/floor/plating/rust,/area/ruin/unpowered)
"rj" = (/obj/machinery/conveyor{dir = 4; id = "abandoned_factory_conveyor"},/obj/item/stack/rods,/obj/structure/sign/poster/ripped{pixel_y = 32},/turf/open/floor/iron/smooth_large,/area/ruin/unpowered)
"rz" = (/obj/effect/turf_decal/caution/stand_clear/red{dir = 4},/obj/structure/cable,/turf/open/floor/iron/smooth_large,/area/ruin/unpowered)
"rC" = (/obj/effect/turf_decal/stripes/line,/obj/effect/decal/cleanable/dirt,/obj/effect/decal/cleanable/generic,/obj/effect/spawner/lootdrop/tool,/obj/structure/table,/turf/open/floor/iron/smooth_large,/area/ruin/unpowered)
"rN" = (/obj/effect/turf_decal/stripes/line,/obj/effect/decal/cleanable/dirt,/obj/structure/table,/turf/open/floor/iron/smooth_large,/area/ruin/unpowered)
"rV" = (/obj/item/stack/rods,/obj/structure/rack,/obj/item/stack/sheet/mineral/plasma/five,/obj/item/stack/sheet/mineral/plasma/five,/obj/item/stack/sheet/mineral/plasma/five,/obj/item/wrench/caravan,/obj/machinery/light/small/red/directional/east,/turf/open/floor/plating/rust,/area/ruin/unpowered)
"so" = (/obj/effect/turf_decal/loading_area{dir = 1},/obj/machinery/conveyor_switch/oneway{id = "abandoned_factory_conveyor"},/turf/open/floor/iron/smooth_large,/area/ruin/unpowered)
"sq" = (/obj/machinery/power/port_gen/pacman,/turf/open/floor/plating/rust,/area/ruin/unpowered)
"tn" = (/obj/structure/cable,/obj/structure/cable,/obj/machinery/light/small/red/directional/west,/obj/item/stack/conveyor,/obj/item/stack/conveyor,/obj/item/stack/conveyor,/obj/item/stack/conveyor,/obj/structure/rack,/turf/open/floor/plating/rust,/area/ruin/unpowered)
"tH" = (/obj/effect/decal/cleanable/dirt,/obj/effect/decal/cleanable/generic,/obj/structure/fence/door{dir = 8; open = 1},/turf/open/floor/iron/smooth_large,/area/ruin/unpowered)
"tX" = (/obj/item/ammo_casing/c45{dir = 8; projectile_type = null},/obj/item/ammo_casing/c45{dir = 5; pixel_x = -10; projectile_type = null},/obj/item/ammo_casing/c45{dir = 9; pixel_x = -6; pixel_y = -6; projectile_type = null},/obj/item/ammo_casing/c45{dir = 1; pixel_x = 7; projectile_type = null},/obj/item/ammo_casing/c45{dir = 5; pixel_x = 4; pixel_y = 9; projectile_type = null},/obj/effect/decal/cleanable/blood/footprints,/obj/effect/decal/cleanable/dirt,/turf/open/floor/iron/smooth_large,/area/ruin/unpowered)
"uh" = (/obj/effect/decal/remains/human{pixel_x = 8; pixel_y = 15},/obj/effect/decal/cleanable/blood/old,/obj/effect/decal/cleanable/blood/gibs/old{pixel_y = 18},/obj/effect/decal/cleanable/dirt,/turf/open/floor/iron/smooth_large,/area/ruin/unpowered)
"uU" = (/obj/structure/fence{dir = 4},/obj/effect/spawner/clear,/obj/effect/spawner/clear,/turf/template_noop,/area/template_noop)
"vl" = (/obj/effect/decal/cleanable/molten_object/large,/turf/open/floor/iron/smooth_large,/area/ruin/unpowered)
"vw" = (/obj/item/chair/stool,/obj/effect/decal/cleanable/dirt,/obj/effect/decal/cleanable/dirt,/obj/effect/spawner/lootdrop/food_packaging,/turf/open/floor/iron/smooth_large,/area/ruin/unpowered)
"vB" = (/turf/open/floor/plating/planetary/rock,/area/template_noop)
"vG" = (/obj/effect/decal/cleanable/dirt,/obj/effect/spawner/lootdrop/gross_decal_spawner,/obj/structure/cable,/turf/open/floor/iron/smooth_half,/area/ruin/unpowered)
"vL" = (/obj/machinery/door/poddoor/shutters{id = "abandoned_factory_north_shutters"},/turf/open/floor/plating/rust,/area/ruin/unpowered)
"wX" = (/obj/structure/table/greyscale,/obj/effect/spawner/lootdrop/food_packaging,/obj/machinery/light/small/directional/east,/turf/open/floor/iron/smooth_large,/area/ruin/unpowered)
"xv" = (/obj/effect/turf_decal/stripes/line,/obj/structure/table,/obj/item/stack/sheet/iron/twenty,/turf/open/floor/iron/smooth_large,/area/ruin/unpowered)
"xC" = (/obj/effect/decal/cleanable/wrapping,/obj/structure/chair/greyscale{dir = 4},/turf/open/floor/plating/rust,/area/ruin/unpowered)
"ya" = (/obj/effect/decal/cleanable/generic,/obj/effect/decal/cleanable/oil/slippery,/turf/open/floor/plating/rust,/area/ruin/unpowered)
"zr" = (/obj/structure/girder,/turf/template_noop,/area/template_noop)
"zt" = (/obj/effect/turf_decal/loading_area{dir = 1},/turf/open/floor/iron/smooth_large,/area/ruin/unpowered)
"zX" = (/obj/effect/decal/cleanable/dirt,/obj/effect/decal/cleanable/generic,/turf/open/floor/iron/smooth_large,/area/ruin/unpowered)
"Ar" = (/obj/structure/fence/corner{dir = 8},/obj/effect/spawner/clear,/obj/effect/spawner/clear,/turf/template_noop,/area/template_noop)
"BE" = (/obj/effect/spawner/clear,/obj/effect/spawner/clear,/turf/template_noop,/area/template_noop)
"BQ" = (/obj/structure/fence{dir = 8},/turf/template_noop,/area/template_noop)
"Cg" = (/turf/closed/wall/rust,/area/ruin/unpowered)
"Cm" = (/obj/machinery/conveyor{dir = 4; id = "abandoned_factory_conveyor"},/obj/item/stack/rods,/obj/item/stack/sheet/iron/ten,/turf/open/floor/iron/smooth_large,/area/ruin/unpowered)
"CS" = (/obj/effect/decal/cleanable/robot_debris,/obj/machinery/conveyor_switch/oneway{id = "abandoned_factory_conveyor"},/turf/open/floor/iron/smooth_large,/area/ruin/unpowered)
"Ep" = (/mob/living/simple_animal/hostile/giant_spider/hunter,/turf/open/floor/iron/smooth_large,/area/ruin/unpowered)
"EI" = (/obj/machinery/conveyor{dir = 1; id = "abandoned_factory_conveyor"},/obj/machinery/light/small/built/directional/west,/turf/open/floor/plating/rust,/area/ruin/unpowered)
"Fp" = (/obj/structure/closet/crate,/turf/open/floor/iron/smooth_half{dir = 1},/area/ruin/unpowered)
"Fu" = (/turf/closed/wall/r_wall/rust,/area/ruin/unpowered)
"Fw" = (/obj/structure/fence,/obj/structure/fence,/obj/effect/spawner/clear,/turf/template_noop,/area/template_noop)
"FF" = (/obj/structure/cable,/obj/machinery/power/terminal,/obj/machinery/power/apc/auto_name/south{start_charge = 0},/obj/item/kirbyplants/random,/turf/open/floor/iron/grimy,/area/ruin/unpowered)
"FH" = (/obj/structure/fence/corner{dir = 10},/obj/effect/spawner/clear,/obj/effect/spawner/clear,/turf/template_noop,/area/template_noop)
"FK" = (/obj/effect/decal/cleanable/blood/footprints{dir = 1; pixel_x = -4; pixel_y = 13},/obj/effect/decal/cleanable/blood/footprints{dir = 1; pixel_x = -13; pixel_y = 3},/obj/effect/decal/cleanable/blood/footprints,/obj/effect/decal/cleanable/dirt,/obj/structure/cable,/turf/open/floor/iron/grimy,/area/ruin/unpowered)
"FT" = (/obj/effect/decal/cleanable/blood/footprints{dir = 4; pixel_y = 10},/obj/effect/decal/cleanable/blood/footprints{dir = 8; pixel_x = -13; pixel_y = 13},/obj/effect/decal/cleanable/dirt,/obj/effect/decal/cleanable/dirt,/obj/structure/chair/plastic{dir = 1},/turf/open/floor/iron/grimy,/area/ruin/unpowered)
"GS" = (/obj/effect/turf_decal/stripes/line,/obj/structure/table_frame,/turf/open/floor/iron/smooth_large,/area/ruin/unpowered)
"He" = (/obj/effect/decal/cleanable/blood/footprints{dir = 4; pixel_y = 10},/obj/effect/decal/cleanable/blood/footprints,/obj/effect/decal/cleanable/dirt,/obj/item/chair/plastic,/turf/open/floor/iron/grimy,/area/ruin/unpowered)
"HS" = (/obj/machinery/door/airlock/maintenance_hatch,/obj/structure/barricade/wooden/crude,/obj/effect/decal/cleanable/blood/footprints,/turf/open/floor/plating/rust,/area/ruin/unpowered)
"HV" = (/obj/effect/turf_decal/stripes/line,/obj/effect/turf_decal/stripes/line,/obj/effect/decal/cleanable/dirt,/obj/machinery/light/small/directional/east,/turf/open/floor/iron/smooth_large,/area/ruin/unpowered)
"Il" = (/obj/effect/decal/cleanable/wrapping{pixel_y = 17},/obj/structure/spider/stickyweb,/turf/open/floor/iron/smooth_half{dir = 1},/area/ruin/unpowered)
"IQ" = (/obj/effect/decal/cleanable/wrapping{pixel_x = -13; pixel_y = 20},/obj/structure/spider/stickyweb,/turf/open/floor/iron/smooth_large,/area/ruin/unpowered)
"IX" = (/obj/structure/frame/computer{anchored = 1},/turf/open/floor/plating/rust,/area/ruin/unpowered)
"Ja" = (/obj/structure/fence{dir = 8},/turf/open/floor/plating/planetary/rock,/area/template_noop)
"Jd" = (/obj/structure/spider/stickyweb,/turf/open/floor/iron/smooth_large,/area/ruin/unpowered)
"Jw" = (/turf/open/floor/plating/planetary/rock,/area/ruin/unpowered)
"JC" = (/obj/effect/turf_decal/box/corners,/obj/effect/turf_decal/box/corners{dir = 8},/obj/item/chair,/obj/structure/rack,/turf/open/floor/iron/smooth_half{dir = 1},/area/ruin/unpowered)
"JL" = (/obj/structure/fence,/obj/effect/spawner/clear,/obj/effect/spawner/clear,/turf/template_noop,/area/template_noop)
"JS" = (/obj/effect/decal/cleanable/dirt,/obj/structure/cable,/turf/open/floor/plating/rust,/area/ruin/unpowered)
"Ke" = (/obj/effect/decal/cleanable/blood/footprints{dir = 8; pixel_x = -13; pixel_y = 13},/obj/structure/barricade/wooden/crude,/obj/structure/cable,/obj/machinery/door/airlock/maintenance/external{locked = 1},/turf/open/floor/plating/rust,/area/ruin/unpowered)
"Ki" = (/obj/structure/closet/crate/trashcart,/obj/effect/decal/cleanable/cobweb,/turf/open/floor/iron/smooth_corner,/area/ruin/unpowered)
"LH" = (/obj/effect/decal/cleanable/molten_object/large,/obj/effect/decal/cleanable/garbage,/obj/effect/decal/cleanable/dirt,/obj/structure/sign/poster/official/work_for_a_future{pixel_y = 32},/turf/open/floor/iron/smooth_half,/area/ruin/unpowered)
"LM" = (/obj/structure/cable,/obj/machinery/power/smes{panel_open = 1},/turf/open/floor/plating/rust,/area/ruin/unpowered)
"LY" = (/obj/structure/cable,/turf/open/floor/plating/rust,/area/ruin/unpowered)
"MB" = (/turf/closed/wall,/area/ruin/unpowered)
"MP" = (/obj/effect/turf_decal/stripes/line,/obj/effect/spawner/lootdrop/tool,/obj/structure/table,/turf/open/floor/iron/smooth_large,/area/ruin/unpowered)
"Nw" = (/obj/effect/decal/cleanable/dirt,/obj/item/stack/rods,/obj/effect/spawner/lootdrop/garbage_spawner,/obj/structure/rack,/turf/open/floor/iron/smooth_half,/area/ruin/unpowered)
"Oj" = (/obj/machinery/vending/sovietsoda,/turf/open/floor/iron/smooth_half,/area/ruin/unpowered)
"OY" = (/obj/machinery/vending/cigarette,/turf/open/floor/plating/rust,/area/ruin/unpowered)
"OZ" = (/obj/structure/fence/corner{dir = 8},/turf/open/floor/iron/smooth_large,/area/ruin/unpowered)
"PD" = (/obj/effect/decal/cleanable/oil,/obj/structure/rack,/obj/item/stack/cable_coil,/obj/item/stack/conveyor,/obj/item/stack/conveyor,/obj/item/stack/conveyor,/obj/item/stack/conveyor,/obj/item/stack/conveyor,/obj/item/stack/conveyor,/turf/open/floor/plating/rust,/area/ruin/unpowered)
"PF" = (/obj/machinery/conveyor{dir = 4; id = "abandoned_factory_conveyor"},/obj/structure/sign/poster/ripped{pixel_y = 32},/turf/open/floor/iron/smooth_large,/area/ruin/unpowered)
"PY" = (/obj/structure/frame{anchored = 1},/obj/effect/decal/cleanable/robot_debris/down,/turf/open/floor/iron/smooth_large,/area/ruin/unpowered)
"Qd" = (/obj/effect/spawner/lootdrop/gross_decal_spawner,/turf/open/floor/iron/smooth_large,/area/ruin/unpowered)
"Qj" = (/obj/effect/decal/cleanable/blood/footprints,/obj/effect/decal/cleanable/blood/old,/turf/open/floor/plating/rust,/area/ruin/unpowered)
"Qk" = (/obj/effect/decal/cleanable/dirt,/obj/effect/spawner/lootdrop/medical,/obj/structure/closet/secure_closet/medical1,/obj/item/clothing/neck/stethoscope,/turf/open/floor/iron/smooth_half,/area/ruin/unpowered)
"Qu" = (/obj/structure/cable,/turf/open/floor/iron/smooth_half,/area/ruin/unpowered)
"Qx" = (/obj/effect/decal/cleanable/dirt,/obj/structure/cable,/obj/machinery/light/small/broken/directional/west,/obj/structure/sign/poster/official/do_not_question{pixel_x = -32},/turf/open/floor/iron/smooth_half{dir = 1},/area/ruin/unpowered)
"QL" = (/obj/effect/turf_decal/stripes/line,/obj/effect/decal/cleanable/oil/slippery,/obj/effect/spawner/lootdrop/tool,/obj/structure/table,/turf/open/floor/iron/smooth_large,/area/ruin/unpowered)
"QV" = (/obj/effect/decal/cleanable/dirt,/obj/structure/rack,/obj/effect/spawner/lootdrop/toolbox,/obj/structure/spider/stickyweb,/turf/open/floor/iron/smooth_half,/area/ruin/unpowered)
"Rk" = (/obj/structure/rack,/obj/effect/spawner/lootdrop/tool,/obj/structure/spider/stickyweb,/turf/open/floor/iron/smooth_half,/area/ruin/unpowered)
"Rv" = (/obj/effect/turf_decal/weather,/turf/open/floor/plating/rust,/area/ruin/unpowered)
"RG" = (/obj/structure/fence{dir = 8},/obj/effect/spawner/clear,/turf/open/floor/plating/planetary/rock,/area/template_noop)
"RL" = (/obj/effect/turf_decal/stripes/line{dir = 4},/obj/effect/decal/cleanable/dirt,/turf/open/floor/iron/smooth_half,/area/ruin/unpowered)
"Sv" = (/obj/machinery/conveyor{dir = 1; id = "abandoned_factory_conveyor"},/turf/open/floor/iron/smooth_large,/area/ruin/unpowered)
"Tb" = (/obj/effect/spawner/clear,/obj/effect/spawner/clear,/obj/effect/spawner/clear,/turf/template_noop,/area/template_noop)
"Tf" = (/obj/machinery/conveyor_switch/oneway{id = "abandoned_factory_conveyor"},/obj/structure/spider/stickyweb,/turf/open/floor/iron/smooth_large,/area/ruin/unpowered)
"Tj" = (/obj/effect/decal/cleanable/dirt,/obj/structure/cable,/obj/structure/fence,/turf/open/floor/iron/smooth_half,/area/ruin/unpowered)
"Ty" = (/obj/structure/spider/stickyweb,/turf/open/floor/iron/smooth_half{dir = 1},/area/ruin/unpowered)
"Tz" = (/obj/effect/decal/cleanable/dirt,/obj/effect/spawner/lootdrop/gross_decal_spawner,/turf/open/floor/iron/smooth_large,/area/ruin/unpowered)
"TF" = (/obj/effect/decal/cleanable/cobweb,/obj/effect/decal/cleanable/garbage,/obj/structure/cable,/turf/open/floor/iron/smooth_corner,/area/ruin/unpowered)
"TM" = (/obj/structure/pitgrate,/turf/open/floor/plating/planetary/rock,/area/ruin/unpowered)
"Ui" = (/obj/effect/decal/cleanable/blood/footprints{dir = 1; pixel_x = -4; pixel_y = 13},/obj/effect/decal/cleanable/blood/footprints{dir = 1; pixel_x = -12; pixel_y = 24},/obj/effect/decal/cleanable/dirt,/obj/structure/cable,/turf/open/floor/iron/smooth_half,/area/ruin/unpowered)
"Us" = (/obj/effect/decal/cleanable/blood/footprints{dir = 8; pixel_x = -13; pixel_y = 13},/obj/effect/decal/cleanable/dirt,/turf/open/floor/iron/smooth_half,/area/ruin/unpowered)
"Ut" = (/obj/effect/decal/cleanable/blood/footprints{dir = 8; pixel_x = -13; pixel_y = 13},/turf/open/floor/iron/smooth_half,/area/ruin/unpowered)
"Uz" = (/obj/effect/decal/cleanable/blood/footprints{dir = 8; pixel_x = -13; pixel_y = 13},/obj/effect/spawner/lootdrop/garbage_spawner,/turf/open/floor/iron/smooth_corner{dir = 1},/area/ruin/unpowered)
"UN" = (/obj/item/beacon,/turf/open/floor/plating/rust,/area/ruin/unpowered)
"UR" = (/obj/effect/decal/cleanable/blood/footprints{dir = 8; pixel_x = 4; pixel_y = 9},/obj/effect/decal/cleanable/blood/footprints{dir = 8; pixel_x = -13; pixel_y = 13},/obj/effect/decal/cleanable/dirt,/obj/effect/decal/cleanable/generic,/turf/open/floor/iron/smooth_large,/area/ruin/unpowered)
"UT" = (/obj/effect/decal/cleanable/blood/footprints{dir = 8; pixel_x = -13; pixel_y = 13},/obj/effect/decal/cleanable/blood/footprints{dir = 8; pixel_x = -5; pixel_y = 4},/obj/effect/decal/cleanable/dirt,/turf/open/floor/iron/smooth_large,/area/ruin/unpowered)
"Vn" = (/obj/effect/decal/cleanable/blood/footprints{dir = 8; pixel_x = -13; pixel_y = 13},/obj/effect/decal/cleanable/dirt,/turf/open/floor/iron/smooth_large,/area/ruin/unpowered)
"Wm" = (/obj/effect/decal/cleanable/blood/footprints{dir = 8; pixel_x = -13; pixel_y = 13},/obj/effect/decal/cleanable/blood/footprints,/obj/effect/decal/cleanable/blood/footprints{dir = 1; pixel_x = -7},/obj/effect/decal/cleanable/blood/footprints{dir = 1; pixel_x = 2},/obj/machinery/light/small/built/directional/south,/turf/open/floor/iron/smooth_large,/area/ruin/unpowered)
"WC" = (/obj/effect/decal/cleanable/blood/footprints{dir = 8; pixel_x = -13; pixel_y = 13},/turf/open/floor/iron/smooth_large,/area/ruin/unpowered)
"Xf" = (/turf/open/floor/plating/rust,/area/ruin/unpowered)
"XP" = (/obj/structure/frame{anchored = 1},/turf/open/floor/plating/rust,/area/ruin/unpowered)
"YD" = (/obj/effect/spawner/lootdrop/gross_decal_spawner,/mob/living/simple_animal/hostile/giant_spider,/turf/open/floor/iron/smooth_large,/area/ruin/unpowered)
"YZ" = (/obj/effect/spawner/clear,/turf/template_noop,/area/template_noop)
"Zc" = (/obj/effect/decal/cleanable/robot_debris/down{pixel_x = 5; pixel_y = 21},/obj/effect/decal/cleanable/oil,/turf/open/floor/iron/smooth_large,/area/ruin/unpowered)
"Zs" = (/obj/effect/decal/cleanable/dirt,/obj/structure/cable,/turf/open/floor/iron/smooth_half,/area/ruin/unpowered)
"Zt" = (/turf/open/floor/iron/smooth_half{dir = 1},/area/ruin/unpowered)
"Zv" = (/obj/structure/fence/door{dir = 8},/turf/open/floor/plating/planetary/rock,/area/template_noop)
"ZC" = (/obj/structure/fence,/obj/effect/decal/cleanable/oil/slippery,/turf/open/floor/iron/smooth_large,/area/ruin/unpowered)
"ZI" = (/obj/machinery/door/airlock/maintenance/external{locked = 1},/turf/open/floor/plating/rust,/area/ruin/unpowered)
"ZU" = (/obj/effect/turf_decal/stripes/line,/obj/effect/decal/cleanable/dirt,/turf/open/floor/iron/smooth_large,/area/ruin/unpowered)
"ZX" = (/obj/effect/decal/cleanable/dirt,/turf/open/floor/plating/planetary/rock,/area/ruin/unpowered)
"ZZ" = (/obj/structure/fence{dir = 4},/obj/effect/spawner/clear,/turf/template_noop,/area/template_noop)

(1,1,1) = {"
nInInInIYZYZYZYZYZnInInIBEYZYZnInInInIYZYZYZYZYZYZYZYZ
nIArZZZZZZZZZZZZZZZZZZZZuUZZZZZZZZZZZZZZaDbnZZZZZZbwYZ
YZbEYZYZYZYZYZYZYZYZYZYZBEYZYZYZYZYZYZYZvBvBnInInIbEYZ
BEbZvBcfcfcDcDcfcfCgCgMBMBCgMBCgCgCgMBMBvLvLMBMBnIbEYZ
YZbEvBcfcPdldxdGFueefoCgfygbgggVifiECgjsjulalgMBnIbEYZ
nIbEYZFumCoVphpiFuhRprqmqnqFtXuhvwwXCgxCzXEpFpCgnIbEYZ
YZFwYZFuFFFKFTHecfMBCgCgCgCgHSMBCgMBMBIlIQJdJCCgnIJLnI
nIbEYZcfcfKecDcDcfKiLHNwOjOYQjQkQVRkRLSvTfJdTycDnIbEnI
nIbEYZCgTFUiUsUtUtUzURUTVnWmWCXfXfJdXfSvXfYDZtCgnIbEnI
YZZvvBZIXfXfZUHVMBMPxvrNQLCgrCbpGSeUCgEIJwkIXfCgnIbEnI
YZbEYZMBQxXfUNXfrjCmvlnPoFaXnPkInPnPPFSvXfOZpmebnIbEnI
YZgJvBaKrzoFoFCSXPIXdoztsoPYqBztjusofMqBkIZCsqCgvBbEnI
YZfkvBaKrzXfoFRvTMTMyakIoFZcXfXfprXfkITzQdtHrVCgYZbEnI
YZbZYZMBtnLYPDexbcaYRvrdZsvGrdJSZXZXLYQuZsTjLMMBYZbEnI
YZbEYZMBMBCgCgaYYZYZaYCgCgMBMBCgCgCgCgebebMBMBMBYZbEnI
YZbEYZYZYZYZvBvBzrYZYZYZYZYZYZYZYZYZYZvBvBYZYZYZYZbEnI
YZFHgsgsJaJagsgsgsgsgsgsgsgsgsgsgsgsgsBQJaRGgsgsgsiKnI
YZYZYZnInInInInInIYZYZYZYZnInInIYZYZnInInInInIYZYZTbnI
"}
